...*....*.*.*.
**.*.*..*..*..
****..*.*.*.*.
....*..*..*.*.
........*.*..*
********......
.*.*.*.*.*.*..
...*....*.*.*.
**.*.*..*..*..
****..*.*.*.*.
....*..*..*.*.
........*.*..*
********......
.*.*.*.*.*.*..
...*....*.*.*.
**.*.*..*..*..
****..*.*.*.*.
....*..*..*.*.
........*.*..*
********......
.*.*.*.*.*.*..
...*....*.*.*.
**.*.*..*..*..
****..*.*.*.*.
....*..*..*.*.
........*.*..*
********......
.*.*.*.*.*.*..
...*....*.*.*.
**.*.*..*..*..
****..*.*.*.*.
....*..*..*.*.
........*.*..*
********......
.*.*.*.*.*.*..
...*....*.*.*.
**.*.*..*..*..
****..*.*.*.*.
....*..*..*.*.
........*.*..*
********......
.*.*.*.*.*.*..
...*....*.*.*.
**.*.*..*..*..
****..*.*.*.*.
....*..*..*.*.
........*.*..*
********......
.*.*.*.*.*.*..
...*....*.*.*.
**.*.*..*..*..
****..*.*.*.*.
....*..*..*.*.
........*.*..*
********......
.*.*.*.*.*.*..
...*....*.*.*.
**.*.*..*..*..
****..*.*.*.*.
....*..*..*.*.
........*.*..*
********......
.*.*.*.*.*.*..
...*....*.*.*.
**.*.*..*..*..
****..*.*.*.*.
....*..*..*.*.
........*.*..*
********......
.*.*.*.*.*.*..
...*....*.*.*.
**.*.*..*..*..
****..*.*.*.*.
....*..*..*.*.
........*.*..*
********......
.*.*.*.*.*.*..
...*....*.*.*.
**.*.*..*..*..
****..*.*.*.*.
